51 76 46 40 63 54 41 80 68 21 
89 93 16 49 94 87 26 72 19 22 
59 43 51 29 52 57 43 58 49 88 
24 93 57 71 38 72 94 19 11 96 
52 94 76 44 11 80 16 90 87 64 
44 34 90 58 92 25 16 23 68 74 
45 12 50 99 12 84 27 51 48 83 
57 75 49 64 66 43 13 44 98 19 
53 93 69 33 52 30 25 83 47 78 
25 49 61 54 84 53 85 12 41 63 
